<div class=title>What Is The English Word For:</div> <br> <div class=phonetic> rɔ́ɔn </div> <div class=script>  </div> <br>  <br> 	<div class=answer>Answer:</div> <br> <div class=english>hot</div>
<div class=title>What Is The Thai Word For:</div> <br> <div class=english> hot </div> 	<div class=answer>Answer:</div> </br> <div class=phonetic> rɔ́ɔn </div> <div class=script>  </div>  <br> 
<div class=title>What Is The English Word For:</div> <br> <div class=phonetic> nǎao </div> <div class=script>  </div> <br>  <br> 	<div class=answer>Answer:</div> <br> <div class=english>cold</div>
<div class=title>What Is The Thai Word For:</div> <br> <div class=english> cold </div> 	<div class=answer>Answer:</div> </br> <div class=phonetic> nǎao </div> <div class=script>  </div>  <br> 
<div class=title>What Is The English Word For:</div> <br> <div class=phonetic> reo </div> <div class=script>  </div> <br>  <br> 	<div class=answer>Answer:</div> <br> <div class=english>fast</div>
<div class=title>What Is The Thai Word For:</div> <br> <div class=english> fast </div> 	<div class=answer>Answer:</div> </br> <div class=phonetic> reo </div> <div class=script>  </div>  <br> 
<div class=title>What Is The English Word For:</div> <br> <div class=phonetic> cháa </div> <div class=script>  </div> <br>  <br> 	<div class=answer>Answer:</div> <br> <div class=english>slow</div>
<div class=title>What Is The Thai Word For:</div> <br> <div class=english> slow </div> 	<div class=answer>Answer:</div> </br> <div class=phonetic> cháa </div> <div class=script>  </div>  <br> 
<div class=title>What Is The English Word For:</div> <br> <div class=phonetic> yài </div> <div class=script>  </div> <br>  <br> 	<div class=answer>Answer:</div> <br> <div class=english>big</div>
<div class=title>What Is The Thai Word For:</div> <br> <div class=english> big </div> 	<div class=answer>Answer:</div> </br> <div class=phonetic> yài </div> <div class=script>  </div>  <br> 
<div class=title>What Is The English Word For:</div> <br> <div class=phonetic> lék </div> <div class=script>  </div> <br>  <br> 	<div class=answer>Answer:</div> <br> <div class=english>small</div>
<div class=title>What Is The Thai Word For:</div> <br> <div class=english> small </div> 	<div class=answer>Answer:</div> </br> <div class=phonetic> lék </div> <div class=script>  </div>  <br> 
<div class=title>What Is The English Word For:</div> <br> <div class=phonetic> sǔung </div> <div class=script>  </div> <br>  <br> 	<div class=answer>Answer:</div> <br> <div class=english>tall (height)</div>
<div class=title>What Is The Thai Word For:</div> <br> <div class=english> tall (height) </div> 	<div class=answer>Answer:</div> </br> <div class=phonetic> sǔung </div> <div class=script>  </div>  <br> 
<div class=title>What Is The English Word For:</div> <br> <div class=phonetic> dtîa </div> <div class=script>  </div> <br>  <br> 	<div class=answer>Answer:</div> <br> <div class=english>short (height)</div>
<div class=title>What Is The Thai Word For:</div> <br> <div class=english> short (height) </div> 	<div class=answer>Answer:</div> </br> <div class=phonetic> dtîa </div> <div class=script>  </div>  <br> 
<div class=title>What Is The English Word For:</div> <br> <div class=phonetic> sǔai </div> <div class=script>  </div> <br>  <br> 	<div class=answer>Answer:</div> <br> <div class=english>beautiful</div>
<div class=title>What Is The Thai Word For:</div> <br> <div class=english> beautiful </div> 	<div class=answer>Answer:</div> </br> <div class=phonetic> sǔai </div> <div class=script>  </div>  <br> 
<div class=title>What Is The English Word For:</div> <br> <div class=phonetic> kêe nǎi? </div> <div class=script>  </div> <br>  <br> 	<div class=answer>Answer:</div> <br> <div class=english>how much?, to what degree?</div>
<div class=title>What Is The Thai Word For:</div> <br> <div class=english> how much?, to what degree? </div> 	<div class=answer>Answer:</div> </br> <div class=phonetic> kêe nǎi? </div> <div class=script>  </div>  <br> 
<div class=title>What Is The English Word For:</div> <br> <div class=phonetic> ... mâak </div> <div class=script>  </div> <br>  <br> 	<div class=answer>Answer:</div> <br> <div class=english>very...</div>
<div class=title>What Is The Thai Word For:</div> <br> <div class=english> very... </div> 	<div class=answer>Answer:</div> </br> <div class=phonetic> ... mâak </div> <div class=script>  </div>  <br> 
<div class=title>What Is The English Word For:</div> <br> <div class=phonetic> kɔ̂nkâang... </div> <div class=script>  </div> <br>  <br> 	<div class=answer>Answer:</div> <br> <div class=english>quite...</div>
<div class=title>What Is The Thai Word For:</div> <br> <div class=english> quite... </div> 	<div class=answer>Answer:</div> </br> <div class=phonetic> kɔ̂nkâang... </div> <div class=script>  </div>  <br> 
<div class=title>What Is The English Word For:</div> <br> <div class=phonetic> ...nít nɔ̀i </div> <div class=script>  </div> <br>  <br> 	<div class=answer>Answer:</div> <br> <div class=english>a bit...</div>
<div class=title>What Is The Thai Word For:</div> <br> <div class=english> a bit... </div> 	<div class=answer>Answer:</div> </br> <div class=phonetic> ...nít nɔ̀i </div> <div class=script>  </div>  <br> 
<div class=title>What Is The English Word For:</div> <br> <div class=phonetic> mâi kôi... </div> <div class=script>  </div> <br>  <br> 	<div class=answer>Answer:</div> <br> <div class=english>not very...</div>
<div class=title>What Is The Thai Word For:</div> <br> <div class=english> not very... </div> 	<div class=answer>Answer:</div> </br> <div class=phonetic> mâi kôi... </div> <div class=script>  </div>  <br> 
<div class=title>What Is The English Word For:</div> <br> <div class=phonetic> mâi...ləəi </div> <div class=script>  </div> <br>  <br> 	<div class=answer>Answer:</div> <br> <div class=english>not...at all</div>
<div class=title>What Is The Thai Word For:</div> <br> <div class=english> not...at all </div> 	<div class=answer>Answer:</div> </br> <div class=phonetic> mâi...ləəi </div> <div class=script>  </div>  <br> 
<div class=title>What Is The English Word For:</div> <br> <div class=phonetic> (A) ... gwàa (B) </div> <div class=script>  </div> <br>  <br> 	<div class=answer>Answer:</div> <br> <div class=english>(A) is more ... than (B)</div>
<div class=title>What Is The Thai Word For:</div> <br> <div class=english> (A) is more ... than (B) </div> 	<div class=answer>Answer:</div> </br> <div class=phonetic> (A) ... gwàa (B) </div> <div class=script>  </div>  <br> 
<div class=title>What Is The English Word For:</div> <br> <div class=phonetic> (A) ... tâo (B) </div> <div class=script>  </div> <br>  <br> 	<div class=answer>Answer:</div> <br> <div class=english>(A) is as ... as (B)</div>
<div class=title>What Is The Thai Word For:</div> <br> <div class=english> (A) is as ... as (B) </div> 	<div class=answer>Answer:</div> </br> <div class=phonetic> (A) ... tâo (B) </div> <div class=script>  </div>  <br> 
<div class=title>What Is The English Word For:</div> <br> <div class=phonetic> hɔ̂ng </div> <div class=script>  </div> <br>  <br> 	<div class=answer>Answer:</div> <br> <div class=english>room</div>
<div class=title>What Is The Thai Word For:</div> <br> <div class=english> room </div> 	<div class=answer>Answer:</div> </br> <div class=phonetic> hɔ̂ng </div> <div class=script>  </div>  <br> 
<div class=title>What Is The English Word For:</div> <br> <div class=phonetic> gwâang </div> <div class=script>  </div> <br>  <br> 	<div class=answer>Answer:</div> <br> <div class=english>wide, big (room)</div>
<div class=title>What Is The Thai Word For:</div> <br> <div class=english> wide, big (room) </div> 	<div class=answer>Answer:</div> </br> <div class=phonetic> gwâang </div> <div class=script>  </div>  <br> 
<div class=title>What Is The English Word For:</div> <br> <div class=phonetic> dtaaraang méet </div> <div class=script>  </div> <br>  <br> 	<div class=answer>Answer:</div> <br> <div class=english>square metre</div>
<div class=title>What Is The Thai Word For:</div> <br> <div class=english> square metre </div> 	<div class=answer>Answer:</div> </br> <div class=phonetic> dtaaraang méet </div> <div class=script>  </div>  <br> 
<div class=title>What Is The English Word For:</div> <br> <div class=phonetic> kâa châo </div> <div class=script>  </div> <br>  <br> 	<div class=answer>Answer:</div> <br> <div class=english>rent</div>
<div class=title>What Is The Thai Word For:</div> <br> <div class=english> rent </div> 	<div class=answer>Answer:</div> </br> <div class=phonetic> kâa châo </div> <div class=script>  </div>  <br> 
<div class=title>What Is The English Word For:</div> <br> <div class=phonetic> kâa mátjam </div> <div class=script>  </div> <br>  <br> 	<div class=answer>Answer:</div> <br> <div class=english>security deposit</div>
<div class=title>What Is The Thai Word For:</div> <br> <div class=english> security deposit </div> 	<div class=answer>Answer:</div> </br> <div class=phonetic> kâa mátjam </div> <div class=script>  </div>  <br> 
<div class=title>What Is The English Word For:</div> <br> <div class=phonetic> mʉ̀ʉn </div> <div class=script>  </div> <br>  <br> 	<div class=answer>Answer:</div> <br> <div class=english>ten thousand</div>
<div class=title>What Is The Thai Word For:</div> <br> <div class=english> ten thousand </div> 	<div class=answer>Answer:</div> </br> <div class=phonetic> mʉ̀ʉn </div> <div class=script>  </div>  <br> 
<div class=title>What Is The English Word For:</div> <br> <div class=phonetic> dʉan </div> <div class=script>  </div> <br>  <br> 	<div class=answer>Answer:</div> <br> <div class=english>month</div>
<div class=title>What Is The Thai Word For:</div> <br> <div class=english> month </div> 	<div class=answer>Answer:</div> </br> <div class=phonetic> dʉan </div> <div class=script>  </div>  <br> 
<div class=title>What Is The English Word For:</div> <br> <div class=phonetic> tam sǎnyaa ləəi </div> <div class=script>  </div> <br>  <br> 	<div class=answer>Answer:</div> <br> <div class=english>SIgn the contract now</div>
<div class=title>What Is The Thai Word For:</div> <br> <div class=english> SIgn the contract now </div> 	<div class=answer>Answer:</div> </br> <div class=phonetic> tam sǎnyaa ləəi </div> <div class=script>  </div>  <br> 
<div class=title>What Is The English Word For:</div> <br> <div class=phonetic> dtòklong </div> <div class=script>  </div> <br>  <br> 	<div class=answer>Answer:</div> <br> <div class=english>I agree (to do something)</div>
<div class=title>What Is The Thai Word For:</div> <br> <div class=english> I agree (to do something) </div> 	<div class=answer>Answer:</div> </br> <div class=phonetic> dtòklong </div> <div class=script>  </div>  <br> 
<div class=title>What Is The English Word For:</div> <br> <div class=phonetic> yang mâi dtàtsǐn jai </div> <div class=script>  </div> <br>  <br> 	"<div class=answer>Answer:</div> <br> <div class=english>I haven't decided yet</div>"
"<div class=title>What Is The Thai Word For:</div> <br> <div class=english> I haven't decided yet </div> "	<div class=answer>Answer:</div> </br> <div class=phonetic> yang mâi dtàtsǐn jai </div> <div class=script>  </div>  <br> 
<div class=title>What Is The English Word For:</div> <br> <div class=phonetic> hǎa </div> <div class=script>  </div> <br>  <br> 	<div class=answer>Answer:</div> <br> <div class=english>to look for, search</div>
<div class=title>What Is The Thai Word For:</div> <br> <div class=english> to look for, search </div> 	<div class=answer>Answer:</div> </br> <div class=phonetic> hǎa </div> <div class=script>  </div>  <br> 
<div class=title>What Is The English Word For:</div> <br> <div class=phonetic> kɔ̌ɔ&nbsp;kít gɔ̀ɔn </div> <div class=script>  </div> <br>  <br> 	<div class=answer>Answer:</div> <br> <div class=english>Let me think about it first</div>
<div class=title>What Is The Thai Word For:</div> <br> <div class=english> Let me think about it first </div> 	<div class=answer>Answer:</div> </br> <div class=phonetic> kɔ̌ɔ&nbsp;kít gɔ̀ɔn </div> <div class=script>  </div>  <br> 
<div class=title>What Is The English Word For:</div> <br> <div class=phonetic> duu (hông) ʉ̀ʉn dâai mái? </div> <div class=script>  </div> <br>  <br> 	<div class=answer>Answer:</div> <br> <div class=english>Can I look at other (rooms)?</div>
<div class=title>What Is The Thai Word For:</div> <br> <div class=english> Can I look at other (rooms)? </div> 	<div class=answer>Answer:</div> </br> <div class=phonetic> duu (hông) ʉ̀ʉn dâai mái? </div> <div class=script>  </div>  <br> 
<div class=title>What Is The English Word For:</div> <br> <div class=phonetic> hɔ̂ng nɔɔn </div> <div class=script>  </div> <br>  <br> 	<div class=answer>Answer:</div> <br> <div class=english>bedroom</div>
<div class=title>What Is The Thai Word For:</div> <br> <div class=english> bedroom </div> 	<div class=answer>Answer:</div> </br> <div class=phonetic> hɔ̂ng nɔɔn </div> <div class=script>  </div>  <br> 
<div class=title>What Is The English Word For:</div> <br> <div class=phonetic> hɔ̂ng nâng lên </div> <div class=script>  </div> <br>  <br> 	<div class=answer>Answer:</div> <br> <div class=english>living room</div>
<div class=title>What Is The Thai Word For:</div> <br> <div class=english> living room </div> 	<div class=answer>Answer:</div> </br> <div class=phonetic> hɔ̂ng nâng lên </div> <div class=script>  </div>  <br> 
<div class=title>What Is The English Word For:</div> <br> <div class=phonetic> hɔ̂ng náam </div> <div class=script>  </div> <br>  <br> 	<div class=answer>Answer:</div> <br> <div class=english>bathroom (toilet)</div>
<div class=title>What Is The Thai Word For:</div> <br> <div class=english> bathroom (toilet) </div> 	<div class=answer>Answer:</div> </br> <div class=phonetic> hɔ̂ng náam </div> <div class=script>  </div>  <br> 
<div class=title>What Is The English Word For:</div> <br> <div class=phonetic> hɔ̂ng krua </div> <div class=script>  </div> <br>  <br> 	<div class=answer>Answer:</div> <br> <div class=english>kitchen</div>
<div class=title>What Is The Thai Word For:</div> <br> <div class=english> kitchen </div> 	<div class=answer>Answer:</div> </br> <div class=phonetic> hɔ̂ng krua </div> <div class=script>  </div>  <br> 
<div class=title>What Is The English Word For:</div> <br> <div class=phonetic> rabiang </div> <div class=script>  </div> <br>  <br> 	<div class=answer>Answer:</div> <br> <div class=english>balcony</div>
<div class=title>What Is The Thai Word For:</div> <br> <div class=english> balcony </div> 	<div class=answer>Answer:</div> </br> <div class=phonetic> rabiang </div> <div class=script>  </div>  <br> 
<div class=title>What Is The English Word For:</div> <br> <div class=phonetic> sà wâaináam </div> <div class=script>  </div> <br>  <br> 	<div class=answer>Answer:</div> <br> <div class=english>swimming pool</div>
<div class=title>What Is The Thai Word For:</div> <br> <div class=english> swimming pool </div> 	<div class=answer>Answer:</div> </br> <div class=phonetic> sà wâaináam </div> <div class=script>  </div>  <br> 
<div class=title>What Is The English Word For:</div> <br> <div class=phonetic> dtiang </div> <div class=script>  </div> <br>  <br> 	<div class=answer>Answer:</div> <br> <div class=english>bed</div>
<div class=title>What Is The Thai Word For:</div> <br> <div class=english> bed </div> 	<div class=answer>Answer:</div> </br> <div class=phonetic> dtiang </div> <div class=script>  </div>  <br> 
<div class=title>What Is The English Word For:</div> <br> <div class=phonetic> dtó </div> <div class=script>  </div> <br>  <br> 	<div class=answer>Answer:</div> <br> <div class=english>table</div>
<div class=title>What Is The Thai Word For:</div> <br> <div class=english> table </div> 	<div class=answer>Answer:</div> </br> <div class=phonetic> dtó </div> <div class=script>  </div>  <br> 
<div class=title>What Is The English Word For:</div> <br> <div class=phonetic> gâo-îi </div> <div class=script>  </div> <br>  <br> 	<div class=answer>Answer:</div> <br> <div class=english>chair</div>
<div class=title>What Is The Thai Word For:</div> <br> <div class=english> chair </div> 	<div class=answer>Answer:</div> </br> <div class=phonetic> gâo-îi </div> <div class=script>  </div>  <br> 
<div class=title>What Is The English Word For:</div> <br> <div class=phonetic> chán </div> <div class=script>  </div> <br>  <br> 	<div class=answer>Answer:</div> <br> <div class=english>bookcase (shelf)</div>
<div class=title>What Is The Thai Word For:</div> <br> <div class=english> bookcase (shelf) </div> 	<div class=answer>Answer:</div> </br> <div class=phonetic> chán </div> <div class=script>  </div>  <br> 
<div class=title>What Is The English Word For:</div> <br> <div class=phonetic> krʉ̂ang sákpâa </div> <div class=script>  </div> <br>  <br> 	<div class=answer>Answer:</div> <br> <div class=english>washing machine</div>
<div class=title>What Is The Thai Word For:</div> <br> <div class=english> washing machine </div> 	<div class=answer>Answer:</div> </br> <div class=phonetic> krʉ̂ang sákpâa </div> <div class=script>  </div>  <br> 
<div class=title>What Is The English Word For:</div> <br> <div class=phonetic> dtûu yen </div> <div class=script>  </div> <br>  <br> 	<div class=answer>Answer:</div> <br> <div class=english>refrigerator</div>
<div class=title>What Is The Thai Word For:</div> <br> <div class=english> refrigerator </div> 	<div class=answer>Answer:</div> </br> <div class=phonetic> dtûu yen </div> <div class=script>  </div>  <br> 
<div class=title>What Is The English Word For:</div> <br> <div class=phonetic> dtûu sʉ̂apâa </div> <div class=script>  </div> <br>  <br> 	<div class=answer>Answer:</div> <br> <div class=english>closet (clothes)</div>
<div class=title>What Is The Thai Word For:</div> <br> <div class=english> closet (clothes) </div> 	<div class=answer>Answer:</div> </br> <div class=phonetic> dtûu sʉ̂apâa </div> <div class=script>  </div>  <br> 
<div class=title>What Is The English Word For:</div> <br> <div class=phonetic> ɛɛ </div> <div class=script>  </div> <br>  <br> 	<div class=answer>Answer:</div> <br> <div class=english>air conditioner</div>
<div class=title>What Is The Thai Word For:</div> <br> <div class=english> air conditioner </div> 	<div class=answer>Answer:</div> </br> <div class=phonetic> ɛɛ </div> <div class=script>  </div>  <br> 
<div class=title>What Is The English Word For:</div> <br> <div class=phonetic> maikroowéep </div> <div class=script>  </div> <br>  <br> 	<div class=answer>Answer:</div> <br> <div class=english>microwave</div>
<div class=title>What Is The Thai Word For:</div> <br> <div class=english> microwave </div> 	<div class=answer>Answer:</div> </br> <div class=phonetic> maikroowéep </div> <div class=script>  </div>  <br> 
<div class=title>What Is The English Word For:</div> <br> <div class=phonetic> patlom </div> <div class=script>  </div> <br>  <br> 	<div class=answer>Answer:</div> <br> <div class=english>fan</div>
<div class=title>What Is The Thai Word For:</div> <br> <div class=english> fan </div> 	<div class=answer>Answer:</div> </br> <div class=phonetic> patlom </div> <div class=script>  </div>  <br> 
<div class=title>What Is The English Word For:</div> <br> <div class=phonetic> fəənijə̂ə </div> <div class=script>  </div> <br>  <br> 	<div class=answer>Answer:</div> <br> <div class=english>furniture</div>
<div class=title>What Is The Thai Word For:</div> <br> <div class=english> furniture </div> 	<div class=answer>Answer:</div> </br> <div class=phonetic> fəənijə̂ə </div> <div class=script>  </div>  <br> 
<div class=title>What Is The English Word For:</div> <br> <div class=phonetic> wâang </div> <div class=script>  </div> <br>  <br> 	<div class=answer>Answer:</div> <br> <div class=english>available</div>
<div class=title>What Is The Thai Word For:</div> <br> <div class=english> available </div> 	<div class=answer>Answer:</div> </br> <div class=phonetic> wâang </div> <div class=script>  </div>  <br> 
<div class=title>What Is The English Word For:</div> <br> <div class=phonetic> dtàm </div> <div class=script>  </div> <br>  <br> 	<div class=answer>Answer:</div> <br> <div class=english>low</div>
<div class=title>What Is The Thai Word For:</div> <br> <div class=english> low </div> 	<div class=answer>Answer:</div> </br> <div class=phonetic> dtàm </div> <div class=script>  </div>  <br> 
<div class=title>What Is The English Word For:</div> <br> <div class=phonetic> wiu </div> <div class=script>  </div> <br>  <br> 	<div class=answer>Answer:</div> <br> <div class=english>view, scenery</div>
<div class=title>What Is The Thai Word For:</div> <br> <div class=english> view, scenery </div> 	<div class=answer>Answer:</div> </br> <div class=phonetic> wiu </div> <div class=script>  </div>  <br> 
<div class=title>What Is The English Word For:</div> <br> <div class=phonetic> gan </div> <div class=script>  </div> <br>  <br> 	<div class=answer>Answer:</div> <br> <div class=english>together, with each other [reciprocity particle]</div>
<div class=title>What Is The Thai Word For:</div> <br> <div class=english> together, with each other [reciprocity particle] </div> 	<div class=answer>Answer:</div> </br> <div class=phonetic> gan </div> <div class=script>  </div>  <br> 
<div class=title>What Is The English Word For:</div> <br> <div class=phonetic> lûukkáa </div> <div class=script>  </div> <br>  <br> 	<div class=answer>Answer:</div> <br> <div class=english>customer</div>
<div class=title>What Is The Thai Word For:</div> <br> <div class=english> customer </div> 	<div class=answer>Answer:</div> </br> <div class=phonetic> lûukkáa </div> <div class=script>  </div>  <br> 
<div class=title>What Is The English Word For:</div> <br> <div class=phonetic> chɔ̂ɔp </div> <div class=script>  </div> <br>  <br> 	<div class=answer>Answer:</div> <br> <div class=english>to like</div>
<div class=title>What Is The Thai Word For:</div> <br> <div class=english> to like </div> 	<div class=answer>Answer:</div> </br> <div class=phonetic> chɔ̂ɔp </div> <div class=script>  </div>  <br> 
<div class=title>What Is The English Word For:</div> <br> <div class=phonetic> yâak </div> <div class=script>  </div> <br>  <br> 	<div class=answer>Answer:</div> <br> <div class=english>hard/difficult</div>
<div class=title>What Is The Thai Word For:</div> <br> <div class=english> hard/difficult </div> 	<div class=answer>Answer:</div> </br> <div class=phonetic> yâak </div> <div class=script>  </div>  <br> 
<div class=title>What Is The English Word For:</div> <br> <div class=phonetic> ngâai </div> <div class=script>  </div> <br>  <br> 	<div class=answer>Answer:</div> <br> <div class=english>easy</div>
<div class=title>What Is The Thai Word For:</div> <br> <div class=english> easy </div> 	<div class=answer>Answer:</div> </br> <div class=phonetic> ngâai </div> <div class=script>  </div>  <br> 
<div class=title>What Is The English Word For:</div> <br> <div class=phonetic> sa-àat </div> <div class=script>  </div> <br>  <br> 	<div class=answer>Answer:</div> <br> <div class=english>clean</div>
<div class=title>What Is The Thai Word For:</div> <br> <div class=english> clean </div> 	<div class=answer>Answer:</div> </br> <div class=phonetic> sa-àat </div> <div class=script>  </div>  <br> 
<div class=title>What Is The English Word For:</div> <br> <div class=phonetic> sòkgabpròk </div> <div class=script>  </div> <br>  <br> 	<div class=answer>Answer:</div> <br> <div class=english>dirty</div>
<div class=title>What Is The Thai Word For:</div> <br> <div class=english> dirty </div> 	<div class=answer>Answer:</div> </br> <div class=phonetic> sòkgabpròk </div> <div class=script>  </div>  <br> 
<div class=title>What Is The English Word For:</div> <br> <div class=phonetic> pɔ̌ɔm </div> <div class=script>  </div> <br>  <br> 	<div class=answer>Answer:</div> <br> <div class=english>slim</div>
<div class=title>What Is The Thai Word For:</div> <br> <div class=english> slim </div> 	<div class=answer>Answer:</div> </br> <div class=phonetic> pɔ̌ɔm </div> <div class=script>  </div>  <br> 
<div class=title>What Is The English Word For:</div> <br> <div class=phonetic> ûan </div> <div class=script>  </div> <br>  <br> 	<div class=answer>Answer:</div> <br> <div class=english>fat</div>
<div class=title>What Is The Thai Word For:</div> <br> <div class=english> fat </div> 	<div class=answer>Answer:</div> </br> <div class=phonetic> ûan </div> <div class=script>  </div>  <br> 
<div class=title>What Is The English Word For:</div> <br> <div class=phonetic> mài </div> <div class=script>  </div> <br>  <br> 	<div class=answer>Answer:</div> <br> <div class=english>new</div>
<div class=title>What Is The Thai Word For:</div> <br> <div class=english> new </div> 	<div class=answer>Answer:</div> </br> <div class=phonetic> mài </div> <div class=script>  </div>  <br> 
<div class=title>What Is The English Word For:</div> <br> <div class=phonetic> gào </div> <div class=script>  </div> <br>  <br> 	<div class=answer>Answer:</div> <br> <div class=english>old (thing)</div>
<div class=title>What Is The Thai Word For:</div> <br> <div class=english> old (thing) </div> 	<div class=answer>Answer:</div> </br> <div class=phonetic> gào </div> <div class=script>  </div>  <br> 
<div class=title>What Is The English Word For:</div> <br> <div class=phonetic> dtîa </div> <div class=script>  </div> <br>  <br> 	<div class=answer>Answer:</div> <br> <div class=english>short</div>
<div class=title>What Is The Thai Word For:</div> <br> <div class=english> short </div> 	<div class=answer>Answer:</div> </br> <div class=phonetic> dtîa </div> <div class=script>  </div>  <br> 
<div class=title>What Is The English Word For:</div> <br> <div class=phonetic> glâi </div> <div class=script>  </div> <br>  <br> 	<div class=answer>Answer:</div> <br> <div class=english>near</div>
<div class=title>What Is The Thai Word For:</div> <br> <div class=english> near </div> 	<div class=answer>Answer:</div> </br> <div class=phonetic> glâi </div> <div class=script>  </div>  <br> 
<div class=title>What Is The English Word For:</div> <br> <div class=phonetic> glai </div> <div class=script>  </div> <br>  <br> 	<div class=answer>Answer:</div> <br> <div class=english>far</div>
<div class=title>What Is The Thai Word For:</div> <br> <div class=english> far </div> 	<div class=answer>Answer:</div> </br> <div class=phonetic> glai </div> <div class=script>  </div>  <br> 
<div class=title>What Is The English Word For:</div> <br> <div class=phonetic> gɛ̀ɛ </div> <div class=script>  </div> <br>  <br> 	<div class=answer>Answer:</div> <br> <div class=english>old (person)</div>
<div class=title>What Is The Thai Word For:</div> <br> <div class=english> old (person) </div> 	<div class=answer>Answer:</div> </br> <div class=phonetic> gɛ̀ɛ </div> <div class=script>  </div>  <br> 
<div class=title>What Is The English Word For:</div> <br> <div class=phonetic> dèk </div> <div class=script>  </div> <br>  <br> 	<div class=answer>Answer:</div> <br> <div class=english>young (person)</div>
<div class=title>What Is The Thai Word For:</div> <br> <div class=english> young (person) </div> 	<div class=answer>Answer:</div> </br> <div class=phonetic> dèk </div> <div class=script>  </div>  <br> 
<div class=title>What Is The English Word For:</div> <br> <div class=phonetic> sanûuk </div> <div class=script>  </div> <br>  <br> 	<div class=answer>Answer:</div> <br> <div class=english>fun</div>
<div class=title>What Is The Thai Word For:</div> <br> <div class=english> fun </div> 	<div class=answer>Answer:</div> </br> <div class=phonetic> sanûuk </div> <div class=script>  </div>  <br> 
<div class=title>What Is The English Word For:</div> <br> <div class=phonetic> bao </div> <div class=script>  </div> <br>  <br> 	<div class=answer>Answer:</div> <br> <div class=english>quiet (sound)</div>
<div class=title>What Is The Thai Word For:</div> <br> <div class=english> quiet (sound) </div> 	<div class=answer>Answer:</div> </br> <div class=phonetic> bao </div> <div class=script>  </div>  <br> 
<div class=title>What Is The English Word For:</div> <br> <div class=phonetic> dang </div> <div class=script>  </div> <br>  <br> 	<div class=answer>Answer:</div> <br> <div class=english>loud (sound)</div>
<div class=title>What Is The Thai Word For:</div> <br> <div class=english> loud (sound) </div> 	<div class=answer>Answer:</div> </br> <div class=phonetic> dang </div> <div class=script>  </div>  <br> 
<div class=title>What Is The English Word For:</div> <br> <div class=phonetic> sǔai </div> <div class=script>  </div> <br>  <br> 	<div class=answer>Answer:</div> <br> <div class=english>beautiful</div>
<div class=title>What Is The Thai Word For:</div> <br> <div class=english> beautiful </div> 	<div class=answer>Answer:</div> </br> <div class=phonetic> sǔai </div> <div class=script>  </div>  <br> 
<div class=title>What Is The English Word For:</div> <br> <div class=phonetic> nâagliat </div> <div class=script>  </div> <br>  <br> 	<div class=answer>Answer:</div> <br> <div class=english>ugly</div>
<div class=title>What Is The Thai Word For:</div> <br> <div class=english> ugly </div> 	<div class=answer>Answer:</div> </br> <div class=phonetic> nâagliat </div> <div class=script>  </div>  <br> 
<div class=title>What Is The English Word For:</div> <br> <div class=phonetic> krai/konnai </div> <div class=script>  </div> <br>  <br> 	<div class=answer>Answer:</div> <br> <div class=english>who</div>
<div class=title>What Is The Thai Word For:</div> <br> <div class=english> who </div> 	<div class=answer>Answer:</div> </br> <div class=phonetic> krai/konnai </div> <div class=script>  </div>  <br> 
<div class=title>What Is The English Word For:</div> <br> <div class=phonetic> gəənbpai </div> <div class=script>  </div> <br>  <br> 	<div class=answer>Answer:</div> <br> <div class=english>extremely (very, very) (extent qualifier)</div>
<div class=title>What Is The Thai Word For:</div> <br> <div class=english> extremely (very, very) (extent qualifier) </div> 	<div class=answer>Answer:</div> </br> <div class=phonetic> gəənbpai </div> <div class=script>  </div>  <br> 
<div class=title>What Is The English Word For:</div> <br> <div class=phonetic> bpii </div> <div class=script>  </div> <br>  <br> 	<div class=answer>Answer:</div> <br> <div class=english>year</div>
<div class=title>What Is The Thai Word For:</div> <br> <div class=english> year </div> 	<div class=answer>Answer:</div> </br> <div class=phonetic> bpii </div> <div class=script>  </div>  <br> 
<div class=title>What Is The English Word For:</div> <br> <div class=phonetic> lɔ̀ɔ </div> <div class=script>  </div> <br>  <br> 	<div class=answer>Answer:</div> <br> <div class=english>handsome</div>
<div class=title>What Is The Thai Word For:</div> <br> <div class=english> handsome </div> 	<div class=answer>Answer:</div> </br> <div class=phonetic> lɔ̀ɔ </div> <div class=script>  </div>  <br> 
